assets/GrassLand/Terrain/Grassland_Terrain_Tileset.png 16 17
-1 -1 -1 -1 -1 -1 -1 -1 -1 -1 -1 -1 -1 -1 -1 -1 -1  -2
 93 90 89 90 89 90 89 90 89 90 89 90 89 90 89 90  92 -2
 59 -1 -1 -1 -1 -1 -1 -1 -1 -1 -1 -1 -1 -1 -1 -1  56  -2
 59 -1 -1 -1 -1 -1 -1 -1 -1 -1 -1 -1 -1 -1 -1 -1  56  -2
 59 -1 56 -1 -1 -1 -1 -1 -1 -1 -1 -1 -1 -1 -1 -1  56  -2
 59 -1 56 -1 -1 -1 -1 -1 -1 -1 -1 -1 -1 -1 -1 -1  56  -2
 59 -1 56 -1 -1 -1 -1 -1 -1 -1 -1 -1 -1 -1 -1 -1  56  -2
 59 -1 56 -1 -1 -1 -1 -1 -1 -1 -1 -1 -1 -1 -1 -1  56  -2
 59 -1 56 -1 -1 -1 -1 -1 -1 -1 -1 -1 -1 -1 -1 -1  56  -2
 59 -1 56 -1 -1  0  1  2  3 -1 -1 -1 -1 -1 -1 -1  56  -2
 59 -1 56 -1 -1 -1 -1 -1 -1 -1 -1 -1 -1 -1 -1 -1  56  -2
 59 -1 56 -1 -1 -1 -1 -1 -1 -1 -1 -1 -1 -1 -1 -1  56  -2
 59 -1 56 -1 -1 -1 -1 -1 -1 -1  0  1  2  3 -1 -1  56  -2
 59 -1 -1 -1 -1 -1 -1 -1 -1 -1 -1 -1 -1 -1 -1 -1  56  -2
 59 -1 -1 -1 -1 -1 -1 -1 -1 -1 -1 -1 -1 -1 -1 -1  56  -2
 0  1  2  1  2  1  2  1  2  1  2  1  2  1  2  2  3
